11111
1P001
10C01
10E01
11111
