1111111111111111111111111111111111111111
1000000000W0C0W0000110000000000000000001
100C011110000000000110010000000100W00001
1000000W00000000W00110000000C00000001001
1000000000000000000110001110000000W00001
100000000000W0000001100C0000000000011111
11111000000000000001100000W00000W0011111
111110000000000000011110000C000000000W01
10E000000000C0000000000000000000100CWPW1
10000000000000000W0000000000010000000W01
111110000000000000000000000C0W0000011111
1111100000111000000011111110000000011111
100000W001011000000100000001000000000001
1000C00010011000001000000011000000000001
10000001000110000C0000001100010000010001
100W0010000110000W000011000011100W000001
1000011111111000000011000000010000000001
1000000000011000001100000011000000111111
1000C00000011000001111111111000000111111
1111111111111111111111111111111111111111