111111111111111111
10C000001110000W01
101110P11110111111
1100001000000W0001
10110000C111011111
100000111101011111
10000000000000W001
10E01000C101101111
110000000111101111
111111111111111111